1
5 10
7 8
9 13
UUUU####U
UUUU#..#U
UUUU#..#U
UUUU#..#U
######.#U
#......#U
#...#.T#U
#####.###
UUUU#.#.#
UUUU#.#.#
UUUU#.#.#
UUUU#...#
UUUU#####

